88888899993999998888888
800009000000000900000008
800009000000000900000008
800009000000000900000008
800009000000000900000008
800009000000000900000008
800009000000000900000008
800009000000009000000008
800009000000009000000008
800000900000009000000008
800000900000090000000008
800000900000900000000008
800000099909000000000008
800000000909000000000008
888888888909888888888888
800000000909000000000048
800800000909000008808888
800800000000000000000008
800808888888888800008808
800888000000000800000008
800808088808880800080008
800808080808080800080808
800088080808080800080808
800008080808080800000808
808800080808080800008088
800888880808080888808088
800800000808000000000008
800000000808000000000008
888888888888888888888888